あまみはるか	天海春香	人名
きさらぎちはや	如月千早	人名
はぎわらゆきほ	萩原雪歩	人名
たかつきやよい	高槻やよい	人名
あきづきりつこ	秋月律子	人名
みなせいおり	水瀬伊織	人名
みうらあずさ	三浦あずさ	人名
ふたみあみ・まみ	双海亜美・真美	人名
きくちまこと	菊地真	人名
ほしいみき	星井美希	人名
しじょうたかね	四条貴音	人名
がなはひびき	我那覇響	人名
あまみ	天海	姓
きさらぎ	如月	姓
はぎわら	萩原	姓
たかつき	高槻	姓
あきづき	秋月	姓
みなせ	水瀬	姓
みうら	三浦	姓
ふたみ	双海	姓
きくち	菊地	姓
ほしい	星井	姓
しじょう	四条	姓
がなは	我那覇	姓
はるか	春香	名
ちはや	千早	名
ゆきほ	雪歩	名
りつこ	律子	名
いおり	伊織	名
あみ・まみ	亜美・真美	名
まこと	真	名
みき	美希	名
たかね	貴音	名
ひびき	響	名
