しまむらうづき	島村卯月	人名
あべなな	安部菜々	人名
いがらしきょうこ	五十嵐響子	人名
いちのせしき	一ノ瀬志希	人名
おがたちえり	緒方智絵里	人名
おとくらゆうき	乙倉悠貴	人名
くろさきちとせ	黒埼ちとせ	人名
こしみずさちこ	輿水幸子	人名
こばやかわさえ	小早川紗枝	人名
こひなたみほ	小日向美穂	人名
さくままゆ	佐久間まゆ	人名
さくらいももか	櫻井桃華	人名
しいなのりこ	椎名法子	人名
しらぎくほたる	白菊ほたる	人名
しらゆきちよ	白雪千夜	人名
せきひろみ	関裕美	人名
どうみょうじかりん	道明寺歌鈴	人名
なかのゆか	中野有香	人名
はやさかみれい	早坂美玲	人名
ふじもとりな	藤本里奈	人名
ふたばあんず	双葉杏	人名
まえかわみく	前川みく	人名
みずもとゆかり	水本ゆかり	人名
みむらかなこ	三村かな子	人名
みやもとふれでりか	宮本フレデリカ	人名
むなかたあつみ	棟方愛海	人名
ゆさこずえ	遊佐こずえ	人名
あいはらゆきの	相原雪乃	人名
あかにしえりか	赤西瑛梨華	人名
あさのふうか	浅野風香	人名
ありうらかんな	有浦柑奈	人名
あんざいみやこ	安斎都	人名
いけぶくろあきは	池袋晶葉	人名
いまいかな	今井加奈	人名
いむらせつな	井村雪菜	人名
えがみつばき	江上椿	人名
おおたゆう	太田優	人名
おおにしゆりこ	大西由里子	人名
おおぬまくるみ	大沼くるみ	人名
おおはらみちる	大原みちる	人名
おくやまさおり	奥山沙織	人名
くさかべわかば	日下部若葉	人名
くどうしのぶ	工藤忍	人名
くらりす	クラリス	人名
くりはらねね	栗原ネネ	人名
こがこはる	古賀小春	人名
さいおんじことか	西園寺琴歌	人名
さかきばらさとみ	榊原里美	人名
すずみやせいか	涼宮星花	人名
つきみやみやび	月宮雅	人名
つじのあかり	辻野あかり	人名
ながとみはすみ	長富蓮実	人名
にわひとみ	丹羽仁美	人名
はらだみよ	原田美世	人名
ひょうどうれな	兵藤レナ	人名
ふくやままい	福山舞	人名
まつばらさや	松原早耶	人名
まなかみさと	間中美里	人名
むらまつさくら	村松さくら	人名
もちだありさ	持田亜里沙	人名
ももいあずき	桃井あずき	人名
やおふぇいふぇい	楊菲菲	人名
やなぎきよら	柳清良	人名
やなせみゆき	柳瀬美由紀	人名
よこやまちか	横山千佳	人名
りゅ・へな	リュ・ヘナ	人名
しぶやりん	渋谷凛	人名
あなすたしあ	アナスタシア	人名
あらきひな	荒木比奈	人名
かみじょうはるな	上条春菜	人名
かみやなお	神谷奈緒	人名
かわしまみずき	川島瑞樹	人名
かんざきらんこ	神崎蘭子	人名
さぎさわふみか	鷺沢文香	人名
ささきちえ	佐々木千枝	人名
さじょうゆきみ	佐城雪美	人名
しおみしゅうこ	塩見周子	人名
しらさかこうめ	白坂小梅	人名
たかがきかえで	高垣楓	人名
たかふじかこ	鷹富士茄子	人名
ただりいな	多田李衣菜	人名
たちばなありす	橘ありす	人名
にったみなみ	新田美波	人名
にのみやあすか	二宮飛鳥	人名
はやみかなで	速水奏	人名
ひさかわはやて	久川颯	人名
ふじわらはじめ	藤原肇	人名
ほうじょうかれん	北条加蓮	人名
まつながりょう	松永涼	人名
みふねみゆ	三船美優	人名
もりくぼのの	森久保乃々	人名
やまとあき	大和亜季	人名
ゆうきはる	結城晴	人名
わきやまたまみ	脇山珠美	人名
あいかわちなつ	相川千夏	人名
あさりななみ	浅利七海	人名
あやせほのか	綾瀬穂乃香	人名
いじゅういんめぐみ	伊集院惠	人名
うじいえむつみ	氏家むつみ	人名
うめきおとは	梅木音葉	人名
おおいしいずみ	大石泉	人名
おかざきやすは	岡崎泰葉	人名
きしべあやか	岸部彩華	人名
きばまなみ	木場真奈美	人名
きりのあや	桐野アヤ	人名
きりゅうつかさ	桐生つかさ	人名
くろかわちあき	黒川千秋	人名
けいと	ケイト	人名
こむろちなみ	小室千奈美	人名
しのはられい	篠原礼	人名
すなづかあきら	砂塚あきら	人名
せなしおり	瀬名詩織	人名
たかはしれいこ	高橋礼子	人名
たかみねのあ	高峯のあ	人名
とうごうあい	東郷あい	人名
なるみやゆめ	成宮由愛	人名
にしかわほなみ	西川保奈美	人名
はっとりとうこ	服部瞳子	人名
ひいらぎしの	柊志乃	人名
ふじいとも	藤居朋	人名
ふるさわよりこ	古澤頼子	人名
へれん	ヘレン	人名
まつおちづる	松尾千鶴	人名
まつもとさりな	松本沙理奈	人名
みずきせいら	水木聖來	人名
みずのみどり	水野翠	人名
もちづきひじり	望月聖	人名
やがみまきの	八神マキノ	人名
よしおかさき	吉岡沙紀	人名
らいら	ライラ	人名
わくいるみ	和久井留美	人名
じゅにー	ジュニー	人名
ほんだみお	本田未央	人名
あいばゆみ	相葉夕美	人名
あかぎみりあ	赤城みりあ	人名
いちはらにな	市原仁奈	人名
うえだすずほ	上田鈴帆	人名
おいかわしずく	及川雫	人名
おおつきゆい	大槻唯	人名
かたぎりさなえ	片桐早苗	人名
きたひなこ	喜多日菜子	人名
きたみゆず	喜多見柚	人名
きむらなつき	木村夏樹	人名
こせきれいな	小関麗奈	人名
さとうしん	佐藤心	人名
じょうがさきみか	城ヶ崎美嘉	人名
じょうがさきりか	城ヶ崎莉嘉	人名
たかもりあいこ	高森藍子	人名
とときあいり	十時愛梨	人名
なたーりあ	ナターリア	人名
なんじょうひかる	南条光	人名
なんばえみ	難波笑美	人名
はまぐちあやめ	浜口あやめ	人名
ひさかわなぎ	久川凪	人名
ひのあかね	日野茜	人名
ひめかわゆき	姫川友紀	人名
ほししょうこ	星輝子	人名
ほりゆうこ	堀裕子	人名
まとばりさ	的場梨沙	人名
むかいたくみ	向井拓海	人名
むらかみともえ	村上巴	人名
もろぼしきらり	諸星きらり	人名
ゆめみりあむ	夢見りあむ	人名
よりたよしの	依田芳乃	人名
りゅうざきかおる	龍崎薫	人名
あいのなぎさ	愛野渚	人名
いゔ・さんたくろーす	イヴ・サンタクロース	人名
えとうみさき	衛藤美紗希	人名
えびはらなほ	海老原菜帆	人名
きたがわまひろ	北川真尋	人名
きゃしー・ぐらはむ	キャシー・グラハム	人名
こまついぶき	小松伊吹	人名
さいとうようこ	斉藤洋子	人名
さえじまきよみ	冴島清美	人名
さわだまりな	沢田麻理菜	人名
ざいぜんときこ	財前時子	人名
しゅとうあおい	首藤葵	人名
すぎさかうみ	杉坂海	人名
せんざきえま	仙崎恵磨	人名
そうまなつみ	相馬夏美	人名
つちやあこ	土屋亜子	人名
なみきめいこ	並木芽衣子	人名
にしじまかい	西島櫂	人名
ののむらそら	野々村そら	人名
はまかわあゆな	浜川愛結奈	人名
まきはらしほ	槙原志保	人名
まつやまくみこ	松山久美子	人名
まなべいつき	真鍋いつき	人名
みよしさな	三好紗南	人名
めありー・こくらん	メアリー・コクラン	人名
やぐちみう	矢口美羽	人名
わかばやしともか	若林智香	人名
いむ・ゆじん	イム・ユジン	人名
あおきれい	青木麗	人名
あおきせい	青木聖	人名
あおきめい	青木明	人名
あおきけい	青木慶	人名
せんかわちひろ	千川ちひろ	人名
しまむら	島村	姓
あべ	安部	姓
いがらし	五十嵐	姓
いちのせ	一ノ瀬	姓
おがた	緒方	姓
おとくら	乙倉	姓
くろさき	黒埼	姓
こしみず	輿水	姓
こばやかわ	小早川	姓
こひなた	小日向	姓
さくま	佐久間	姓
さくらい	櫻井	姓
しいな	椎名	姓
しらぎく	白菊	姓
しらゆき	白雪	姓
せき	関	姓
どうみょうじ	道明寺	姓
なかの	中野	姓
はやさか	早坂	姓
ふじもと	藤本	姓
ふたば	双葉	姓
まえかわ	前川	姓
みずもと	水本	姓
みむら	三村	姓
みやもと	宮本	姓
むなかた	棟方	姓
ゆさ	遊佐	姓
あいはら	相原	姓
あかにし	赤西	姓
あさの	浅野	姓
ありうら	有浦	姓
あんざい	安斎	姓
いけぶくろ	池袋	姓
いまい	今井	姓
いむら	井村	姓
えがみ	江上	姓
おおた	太田	姓
おおにし	大西	姓
おおぬま	大沼	姓
おおはら	大原	姓
おくやま	奥山	姓
くさかべ	日下部	姓
くどう	工藤	姓
くりはら	栗原	姓
こが	古賀	姓
さいおんじ	西園寺	姓
さかきばら	榊原	姓
すずみや	涼宮	姓
つきみや	月宮	姓
つじの	辻野	姓
ながとみ	長富	姓
にわ	丹羽	姓
はらだ	原田	姓
ひょうどう	兵藤	姓
ふくやま	福山	姓
まつばら	松原	姓
まなか	間中	姓
むらまつ	村松	姓
もちだ	持田	姓
ももい	桃井	姓
やお	楊	姓
やなぎ	柳	姓
やなせ	柳瀬	姓
よこやま	横山	姓
しぶや	渋谷	姓
あらき	荒木	姓
かみじょう	上条	姓
かみや	神谷	姓
かわしま	川島	姓
かんざき	神崎	姓
さぎさわ	鷺沢	姓
ささき	佐々木	姓
さじょう	佐城	姓
しおみ	塩見	姓
しらさか	白坂	姓
たかがき	高垣	姓
たかふじ	鷹富士	姓
ただ	多田	姓
たちばな	橘	姓
にった	新田	姓
にのみや	二宮	姓
はやみ	速水	姓
ひさかわ	久川	姓
ふじわら	藤原	姓
ほうじょう	北条	姓
まつなが	松永	姓
みふね	三船	姓
もりくぼ	森久保	姓
やまと	大和	姓
ゆうき	結城	姓
わきやま	脇山	姓
あいかわ	相川	姓
あさり	浅利	姓
あやせ	綾瀬	姓
いじゅういん	伊集院	姓
うじいえ	氏家	姓
うめき	梅木	姓
おおいし	大石	姓
おかざき	岡崎	姓
きしべ	岸部	姓
きば	木場	姓
きりの	桐野	姓
きりゅう	桐生	姓
くろかわ	黒川	姓
こむろ	小室	姓
しのはら	篠原	姓
すなづか	砂塚	姓
せな	瀬名	姓
たかはし	高橋	姓
たかみね	高峯	姓
とうごう	東郷	姓
なるみや	成宮	姓
にしかわ	西川	姓
はっとり	服部	姓
ひいらぎ	柊	姓
ふじい	藤居	姓
ふるさわ	古澤	姓
まつお	松尾	姓
まつもと	松本	姓
みずき	水木	姓
みずの	水野	姓
もちづき	望月	姓
やがみ	八神	姓
よしおか	吉岡	姓
わくい	和久井	姓
ほんだ	本田	姓
あいば	相葉	姓
あかぎ	赤城	姓
いちはら	市原	姓
うえだ	上田	姓
おいかわ	及川	姓
おおつき	大槻	姓
かたぎり	片桐	姓
きた	喜多	姓
きたみ	喜多見	姓
きむら	木村	姓
こせき	小関	姓
さとう	佐藤	姓
じょうがさき	城ヶ崎	姓
たかもり	高森	姓
ととき	十時	姓
なんじょう	南条	姓
なんば	難波	姓
はまぐち	浜口	姓
ひの	日野	姓
ひめかわ	姫川	姓
ほし	星	姓
ほり	堀	姓
まとば	的場	姓
むかい	向井	姓
むらかみ	村上	姓
もろぼし	諸星	姓
ゆめみ	夢見	姓
よりた	依田	姓
りゅうざき	龍崎	姓
あいの	愛野	姓
えとう	衛藤	姓
えびはら	海老原	姓
きたがわ	北川	姓
こまつ	小松	姓
さいとう	斉藤	姓
さえじま	冴島	姓
さわだ	沢田	姓
ざいぜん	財前	姓
しゅとう	首藤	姓
すぎさか	杉坂	姓
せんざき	仙崎	姓
そうま	相馬	姓
つちや	土屋	姓
なみき	並木	姓
にしじま	西島	姓
ののむら	野々村	姓
はまかわ	浜川	姓
まきはら	槙原	姓
まつやま	松山	姓
まなべ	真鍋	姓
みよし	三好	姓
やぐち	矢口	姓
わかばやし	若林	姓
あおき	青木	姓
せんかわ	千川	姓
うづき	卯月	名
なな	菜々	名
きょうこ	響子	名
しき	志希	名
ちえり	智絵里	名
ゆうき	悠貴	名
さちこ	幸子	名
さえ	紗枝	名
みほ	美穂	名
ももか	桃華	名
のりこ	法子	名
ちよ	千夜	名
ひろみ	裕美	名
かりん	歌鈴	名
ゆか	有香	名
みれい	美玲	名
りな	里奈	名
あんず	杏	名
かなこ	かな子	名
あつみ	愛海	名
ゆきの	雪乃	名
えりか	瑛梨華	名
ふうか	風香	名
かんな	柑奈	名
みやこ	都	名
あきは	晶葉	名
かな	加奈	名
せつな	雪菜	名
つばき	椿	名
ゆう	優	名
ゆりこ	由里子	名
さおり	沙織	名
わかば	若葉	名
しのぶ	忍	名
こはる	小春	名
ことか	琴歌	名
さとみ	里美	名
せいか	星花	名
みやび	雅	名
はすみ	蓮実	名
ひとみ	仁美	名
みよ	美世	名
まい	舞	名
さや	早耶	名
みさと	美里	名
ありさ	亜里沙	名
ふぇいふぇい	菲菲	名
きよら	清良	名
みゆき	美由紀	名
ちか	千佳	名
りん	凛	名
ひな	比奈	名
はるな	春菜	名
なお	奈緒	名
みずき	瑞樹	名
らんこ	蘭子	名
ふみか	文香	名
ちえ	千枝	名
ゆきみ	雪美	名
しゅうこ	周子	名
こうめ	小梅	名
かえで	楓	名
かこ	茄子	名
りいな	李衣菜	名
みなみ	美波	名
あすか	飛鳥	名
かなで	奏	名
はやて	颯	名
はじめ	肇	名
かれん	加蓮	名
りょう	涼	名
みゆ	美優	名
のの	乃々	名
あき	亜季	名
はる	晴	名
たまみ	珠美	名
ちなつ	千夏	名
ななみ	七海	名
ほのか	穂乃香	名
めぐみ	惠	名
おとは	音葉	名
いずみ	泉	名
やすは	泰葉	名
あやか	彩華	名
まなみ	真奈美	名
ちあき	千秋	名
ちなみ	千奈美	名
れい	礼	名
しおり	詩織	名
れいこ	礼子	名
ゆめ	由愛	名
ほなみ	保奈美	名
とうこ	瞳子	名
しの	志乃	名
とも	朋	名
よりこ	頼子	名
ちづる	千鶴	名
さりな	沙理奈	名
せいら	聖來	名
みどり	翠	名
ひじり	聖	名
さき	沙紀	名
るみ	留美	名
みお	未央	名
ゆみ	夕美	名
にな	仁奈	名
すずほ	鈴帆	名
しずく	雫	名
ゆい	唯	名
さなえ	早苗	名
ひなこ	日菜子	名
ゆず	柚	名
なつき	夏樹	名
れいな	麗奈	名
しん	心	名
みか	美嘉	名
りか	莉嘉	名
あいこ	藍子	名
あいり	愛梨	名
ひかる	光	名
えみ	笑美	名
なぎ	凪	名
あかね	茜	名
ゆき	友紀	名
しょうこ	輝子	名
ゆうこ	裕子	名
りさ	梨沙	名
たくみ	拓海	名
ともえ	巴	名
よしの	芳乃	名
かおる	薫	名
なぎさ	渚	名
みさき	美紗希	名
なほ	菜帆	名
まひろ	真尋	名
いぶき	伊吹	名
ようこ	洋子	名
きよみ	清美	名
まりな	麻理菜	名
ときこ	時子	名
あおい	葵	名
うみ	海	名
えま	恵磨	名
なつみ	夏美	名
あこ	亜子	名
めいこ	芽衣子	名
かい	櫂	名
あゆな	愛結奈	名
しほ	志保	名
くみこ	久美子	名
さな	紗南	名
みう	美羽	名
ともか	智香	名
れい	麗	名
せい	聖	名
めい	明	名
けい	慶	名
