かすがみらい	春日未来	人名
きのしたひなた	木下ひなた	人名
Julia	ジュリア	人名
たかやまさよこ	高山紗代子	人名
たなかことは	田中琴葉	人名
てんくうばしともか	天空橋朋花	人名
はこざきせりか	箱崎星梨花	人名
まつだありさ	松田亜利沙	人名
もがみしずか	最上静香	人名
もちづきあんな	望月杏奈	人名
やぶきかな	矢吹可奈	人名
EmilyStewart	エミリースチュアート	人名
おおがみたまき	大神環	人名
きたかみれいか	北上麗花	人名
こうさかうみ	高坂海美	人名
さたけみなこ	佐竹美奈子	人名
しまばらえれな	島原エレナ	人名
ながよしすばる	永吉昴	人名
ののはらあかね	野々原茜	人名
ばばこのみ	馬場このみ	人名
ふくだのりこ	福田のり子	人名
まいはまあゆむ	舞浜歩	人名
まかべみずき	真壁瑞希	人名
ももせりお	百瀬莉緒	人名
よこやまなお	横山奈緒	人名
いぶきつばさ	伊吹翼	人名
きたざわしほ	北沢志保	人名
しのみやかれん	篠宮可憐	人名
すおうももこ	周防桃子	人名
とくがわまつり	徳川まつり	人名
ところめぐみ	所恵美	人名
とよかわふうか	豊川風花	人名
なかたにいく	中谷育	人名
ななおゆりこ	七尾百合子	人名
にかいどうちづる	二階堂千鶴	人名
みやおみや	宮尾美也	人名
はんだろこ	伴田路子	人名
さくらもりかおり	桜守歌織	人名
しらいしつむぎ	白石紬	人名
あおばみさき	青羽美咲	人名
はやさかそら	早坂そら	人名
かすが	春日	姓
きのした	木下	姓
たかやま	高山	姓
たなか	田中	姓
てんくうばし	天空橋	姓
はこざき	箱崎	姓
まつだ	松田	姓
もがみ	最上	姓
もちづき	望月	姓
やぶき	矢吹	姓
Emily	エミリー	姓
おおがみ	大神	姓
きたかみ	北上	姓
こうさか	高坂	姓
さたけ	佐竹	姓
しまばら	島原	姓
ながよし	永吉	姓
ののはら	野々原	姓
ばば	馬場	姓
ふくだ	福田	姓
まいはま	舞浜	姓
まかべ	真壁	姓
ももせ	百瀬	姓
よこやま	横山	姓
いぶき	伊吹	姓
きたざわ	北沢	姓
しのみや	篠宮	姓
すおう	周防	姓
とくがわ	徳川	姓
ところ	所	姓
とよかわ	豊川	姓
なかたに	中谷	姓
ななお	七尾	姓
にかいどう	二階堂	姓
みやお	宮尾	姓
はんだ	伴田	姓
さくらもり	桜守	姓
しらいし	白石	姓
あおば	青羽	姓
はやさか	早坂	姓
みらい	未来	名
さよこ	紗代子	名
ことは	琴葉	名
ともか	朋花	名
せりか	星梨花	名
ありさ	亜利沙	名
しずか	静香	名
あんな	杏奈	名
かな	可奈	名
Stewart	スチュアート	名
たまき	環	名
れいか	麗花	名
うみ	海美	名
みなこ	美奈子	名
すばる	昴	名
あかね	茜	名
のりこ	のり子	名
あゆむ	歩	名
みずき	瑞希	名
りお	莉緒	名
なお	奈緒	名
つばさ	翼	名
しほ	志保	名
かれん	可憐	名
ももこ	桃子	名
めぐみ	恵美	名
ふうか	風花	名
いく	育	名
ゆりこ	百合子	名
ちづる	千鶴	名
みや	美也	名
ろこ	路子	名
かおり	歌織	名
つむぎ	紬	名
みさき	美咲	名
