さくらぎまの	櫻木真乃	人名
かざのひおり	風野灯織	人名
はちみやめぐる	八宮めぐる	人名
つきおかこがね	月岡恋鐘	人名
ゆうこくきりこ	幽谷霧子	人名
たなかまみみ	田中摩美々	人名
しらせさくや	白瀬咲耶	人名
みつみねゆいか	三峰結華	人名
こみやかほ	小宮果穂	人名
そのだちよこ	園田智代子	人名
もりのりんぜ	杜野凛世	人名
ありすがわなつは	有栖川夏葉	人名
さいじょうじゅり	西城樹里	人名
おおさきあまな	大崎甘奈	人名
おおさきてんか	大崎甜花	人名
くわやまちゆき	桑山千雪	人名
せりざわあさひ	芹沢あさひ	人名
まゆずみふゆこ	黛冬優子	人名
いずみめい	和泉愛依	人名
あまいつとむ	天井努	人名
ななくさはづき	七草はづき	人名
さくらぎ	櫻木	姓
かざの	風野	姓
はちみや	八宮	姓
つきおか	月岡	姓
ゆうこく	幽谷	姓
たなか	田中	姓
しらせ	白瀬	姓
みつみね	三峰	姓
こみや	小宮	姓
そのだ	園田	姓
もりの	杜野	姓
ありすがわ	有栖川	姓
さいじょう	西城	姓
おおさき	大崎	姓
くわやま	桑山	姓
せりざわ	芹沢	姓
まゆずみ	黛	姓
いずみ	和泉	姓
あまい	天井	姓
ななくさ	七草	姓
まの	真乃	名
ひおり	灯織	名
こがね	恋鐘	名
きりこ	霧子	名
まみみ	摩美々	名
さくや	咲耶	名
ゆいか	結華	名
かほ	果穂	名
ちよこ	智代子	名
りんぜ	凛世	名
なつは	夏葉	名
じゅり	樹里	名
あまな	甘奈	名
てんか	甜花	名
ちゆき	千雪	名
ふゆこ	冬優子	名
めい	愛依	名
つとむ	努	名
