あまがせとうま	天ヶ瀬冬馬	人名
みたらいしょうた	御手洗翔太	人名
いじゅういんほくと	伊集院北斗	人名
てんどうてる	天道輝	人名
さくらばかおる	桜庭薫	人名
かしわぎつばさ	柏木翼	人名
つづきけい	都築圭	人名
かぐられい	神楽麗	人名
たかじょうきょうじ	鷹城恭二	人名
ぴえーる	ピエール	人名
わたなべみのり	渡辺みのり	人名
あおいゆうすけ	蒼井悠介	人名
あおいきょうすけ	蒼井享介	人名
あくのひでお	握野英雄	人名
きむらりゅう	木村龍	人名
しんげんせいじ	信玄誠司	人名
ねこやなぎきりお	猫柳キリオ	人名
はなむらしょうま	華村翔真	人名
きよすみくろう	清澄九郎	人名
あきやまはやと	秋山隼人	人名
ふゆみじゅん	冬美旬	人名
さかきなつき	榊夏来	人名
わかざとはるな	若里春名	人名
いせやしき	伊瀬谷四季	人名
あかいすざく	紅井朱雀	人名
くろのげんぶ	黒野玄武	人名
かみやゆきひろ	神谷幸広	人名
しののめそういちろう	東雲荘一郎	人名
あすらんべるぜびゅーと	アスラン=BB II世	人名
うづきまきお	卯月巻緒	人名
みずしまさき	水嶋咲	人名
おかむらなお	岡村直央	人名
たちばなしろう	橘志狼	人名
ひめのかのん	姫野かのん	人名
はざまみちお	硲道夫	人名
まいたるい	舞田類	人名
やましたじろう	山下次郎	人名
たいがたける	大河タケル	人名
えんじょうじみちる	円城寺道流	人名
きざきれん	牙崎漣	人名
あきづきりょう	秋月涼	人名
つくもかずき	九十九一希	人名
かぶとだいご	兜大吾	人名
くずのはあめひこ	葛之葉雨彦	人名
きたむらそら	北村想楽	人名
ころんくりす	古論クリス	人名
さいとうたかし	齋藤孝司	人名
やまむらけん	山村賢	人名
あまがせ	天ヶ瀬	姓
みたらい	御手洗	姓
いじゅういん	伊集院	姓
てんどう	天道	姓
さくらば	桜庭	姓
かしわぎ	柏木	姓
つづき	都築	姓
かぐら	神楽	姓
たかじょう	鷹城	姓
わたなべ	渡辺	姓
あおい	蒼井	姓
あくの	握野	姓
きむら	木村	姓
しんげん	信玄	姓
ねこやなぎ	猫柳	姓
はなむら	華村	姓
きよすみ	清澄	姓
あきやま	秋山	姓
ふゆみ	冬美	姓
さかき	榊	姓
わかざと	若里	姓
いせや	伊瀬谷	姓
あかい	紅井	姓
くろの	黒野	姓
かみや	神谷	姓
しののめ	東雲	姓
うづき	卯月	姓
みずしま	水嶋	姓
おかむら	岡村	姓
たちばな	橘	姓
ひめの	姫野	姓
はざま	硲	姓
まいた	舞田	姓
やました	山下	姓
たいが	大河	姓
えんじょうじ	円城寺	姓
きざき	牙崎	姓
あきづき	秋月	姓
つくも	九十九	姓
かぶと	兜	姓
くずのは	葛之葉	姓
きたむら	北村	姓
ころん	古論	姓
さいとう	齋藤	姓
やまむら	山村	姓
とうま	冬馬	名
しょうた	翔太	名
ほくと	北斗	名
てる	輝	名
かおる	薫	名
つばさ	翼	名
けい	圭	名
れい	麗	名
きょうじ	恭二	名
ゆうすけ	悠介	名
きょうすけ	享介	名
ひでお	英雄	名
りゅう	龍	名
せいじ	誠司	名
しょうま	翔真	名
くろう	九郎	名
はやと	隼人	名
じゅん	旬	名
なつき	夏来	名
はるな	春名	名
しき	四季	名
すざく	朱雀	名
げんぶ	玄武	名
ゆきひろ	幸広	名
そういちろう	荘一郎	名
まきお	巻緒	名
さき	咲	名
なお	直央	名
しろう	志狼	名
みちお	道夫	名
るい	類	名
じろう	次郎	名
みちる	道流	名
れん	漣	名
りょう	涼	名
かずき	一希	名
だいご	大吾	名
あめひこ	雨彦	名
そら	想楽	名
たかし	孝司	名
けん	賢	名
